11000011
12000021
00000000
00000000
12000021
11000011